W W W W W W W W W W W W W W 
W - - - - - - H - - - - - W 
W - - - - H - - H - H E - W 
W - - - C - - - - - - C - W 
W - - - W W W W W H C - - W 
W - - C W - - - W - H C - W 
W - - C W W W W W - - - - W 
W - K - - - - P - - - B - W 
W - - - - H H H H - - - H W 
W W W W W W W W W W W W W W 