W W W W W W W W W W W W W W 
W - - - - - - H - - - - - W 
W - P - - H - - H - H E - W 
W - - - C - - H - - - C - W 
W - - - - - - H - H C - - W 
W - - C - - - - - - - C - W 
W - - C H C - - S - - - - W 
W - K - - - - - - H - B - W 
W - - - - - - - H - - - H W 
W W W W W W W W W W W W W W 